NO ./texture/glass.xpm
SO ./texture/hallway.xpm
WE ./texture/mainhall.xpm
EA ./texture/crate.xpm

F 174,198,207

C 0,0,128


        1111111111111111111111111
        100N000000110000000000001
       1011000001110000000000001
       1001000000000000000000001
111111111011000001110000000000001
100000000011000001110111111111111
11110111111111011100000010001
1111011111  111011101010010001
11000000111101011100000010001
10000000000000001100000010001
10000000000000001101010010001
1100000111010101111101111000111
11110111 1110101 101111010001
11111111 1111111 111111111111




