NO ./texture/glass.xpm
SO             ./texture/glass.xpm
WE   ./texture/mainhall.xpm
EA                      ./texture/crate.xpm

F 174,198,213

C 0,0,128




        111111111111111111111111
        100010000011000000000001
       10110E000111000D000000011
       10010100000000dddddddddd1
111111111011000001110000000000001
1000000000110000011101111D1111111
11110111111111011100000010001
1111011111  111011101010010001
11000000111101011100000010001
10000000000000001100000010001
10000000000000001101010010001
1100000111010101111101111000111
11110111 1110101 101111010001
11111111 1111111 111111111111

